ID	Recs	Parent	Domain	Curr_Domain	Parent_type	r_start_proc	r_stop_proc	r_start_full	r_stop_full	d1_r_start_proc	d1_r_stop_proct	d2_r_start_proc	d2_r_stop_proc	d3_r_start_proc	d3_r_stop_proc	d1_r_start_full	d1_r_stop_full	d2_r_start_full	d2_r_stop_full	d3_r_start_full	d3_r_stop_full	p_start_proc	p_stop_proc	p_start_full	p_stop_full	d1_p_start_proc	d1_p_stop_proct	d2_p_start_proc	d2_p_stop_proc	d3_p_start_proc	d3_p_stop_proc	d1_p_start_full	d1_p_stop_full	d2_p_start_full	d2_p_stop_full	d3_p_start_full	d3_p_stop_full
0	BT_Cry8Ja1	BT_Cry8Ca1	domain3	domain3	minor	1258	1714	1522	1977	0	597	621	1233	1275	1713	264	861	885	1497	1539	1977	1255	1710	1516	1971	0	603	627	1242	1272	1710	261	864	888	1503	1533	1971
0	BT_Cry8Ja1	BT_Cry8Ea2	domain3	domain1	major	1258	1714	1522	1977	0	597	621	1233	1275	1713	264	861	885	1497	1539	1977	1243	1683	1510	1950	0	597	621	1233	1257	1683	264	861	885	1497	1521	1947
0	BT_Cry8Ja1	BT_Cry8Ea2	domain3	domain2	major	1258	1714	1522	1977	0	597	621	1233	1275	1713	264	861	885	1497	1539	1977	1243	1683	1510	1950	0	597	621	1233	1257	1683	264	861	885	1497	1521	1947
2	NOV_Cry1Da1_84.8_ABK35074.1	BT_Cry1Ag1	domain3	domain3	minor	1292	1636	1445	1789	0	600	624	1200	1227	1638	153	753	777	1353	1380	1791	1322	1666	1466	1810	0	603	627	1200	1230	1668	144	747	771	1344	1374	1812
2	NOV_Cry1Da1_84.8_ABK35074.1	BT_Cry1Ad1	domain3	domain3	minor	1292	1636	1445	1789	0	600	624	1200	1227	1638	153	753	777	1353	1380	1791	1322	1666	1466	1810	0	603	627	1224	1230	1668	144	747	771	1368	1374	1812
2	NOV_Cry1Da1_84.8_ABK35074.1	BT_Cry1Aa10	domain3	domain3	minor	1292	1636	1445	1789	0	600	624	1200	1227	1638	153	753	777	1353	1380	1791	1322	1666	1466	1810	0	603	627	1218	1224	1668	144	747	771	1362	1368	1812
2	NOV_Cry1Da1_84.8_ABK35074.1	NOV_Cry1Ad2_87.7_AIW52617.1	domain3	domain3	minor	1292	1636	1445	1789	0	600	624	1200	1227	1638	153	753	777	1353	1380	1791	1322	1666	1466	1810	0	603	627	1218	1224	1668	144	747	771	1362	1368	1812
2	NOV_Cry1Da1_84.8_ABK35074.1	BT_Cry1A-like	domain3	domain3	minor	1292	1636	1445	1789	0	600	624	1200	1227	1638	153	753	777	1353	1380	1791	1310	1654	1454	1798	0	366	714	1209	1215	1656	144	510	858	1353	1359	1800
2	NOV_Cry1Da1_84.8_ABK35074.1	BT_Cry1Ab12	domain3	domain3	minor	1292	1636	1445	1789	0	600	624	1200	1227	1638	153	753	777	1353	1380	1791	1325	1669	1469	1813	0	603	627	1224	1230	1671	144	747	771	1368	1374	1815
2	NOV_Cry1Da1_84.8_ABK35074.1	NOV_Cry1Ab12_91.4_AAK14338.1	domain3	domain3	minor	1292	1636	1445	1789	0	600	624	1200	1227	1638	153	753	777	1353	1380	1791	1325	1669	1463	1807	0	603	627	1224	1230	1671	138	741	765	1362	1368	1809
2	NOV_Cry1Da1_84.8_ABK35074.1	NOV_Cry1Ab32_92.7_AAK14337.1	domain3	domain3	minor	1292	1636	1445	1789	0	600	624	1200	1227	1638	153	753	777	1353	1380	1791	1325	1669	1469	1813	0	603	627	1224	1230	1671	144	747	771	1368	1374	1815
2	NOV_Cry1Da1_84.8_ABK35074.1	BT_Cry1Ab2	domain3	domain3	minor	1292	1636	1445	1789	0	600	624	1200	1227	1638	153	753	777	1353	1380	1791	1331	1672	1475	1816	0	603	627	1239	1242	1674	144	747	771	1383	1386	1818
2	NOV_Cry1Da1_84.8_ABK35074.1	BT_Cry1Ag1	domain3	domain1	major	1292	1636	1445	1789	0	600	624	1200	1227	1638	153	753	777	1353	1380	1791	1322	1666	1466	1810	0	603	627	1200	1230	1668	144	747	771	1344	1374	1812
2	NOV_Cry1Da1_84.8_ABK35074.1	NOV_Cry1Ab32_92.7_AAK14337.1	domain3	domain1	major	1292	1636	1445	1789	0	600	624	1200	1227	1638	153	753	777	1353	1380	1791	1325	1669	1469	1813	0	603	627	1224	1230	1671	144	747	771	1368	1374	1815
2	NOV_Cry1Da1_84.8_ABK35074.1	BT_Cry1Ac39	domain3	domain1	major	1292	1636	1445	1789	0	600	624	1200	1227	1638	153	753	777	1353	1380	1791	1322	1672	1466	1816	0	603	627	1233	1263	1677	144	747	771	1377	1407	1821
2	NOV_Cry1Da1_84.8_ABK35074.1	BT_Cry1Ad1	domain3	domain1	major	1292	1636	1445	1789	0	600	624	1200	1227	1638	153	753	777	1353	1380	1791	1322	1666	1466	1810	0	603	627	1224	1230	1668	144	747	771	1368	1374	1812
2	NOV_Cry1Da1_84.8_ABK35074.1	BT_Cry1Aa10	domain3	domain1	major	1292	1636	1445	1789	0	600	624	1200	1227	1638	153	753	777	1353	1380	1791	1322	1666	1466	1810	0	603	627	1218	1224	1668	144	747	771	1362	1368	1812
2	NOV_Cry1Da1_84.8_ABK35074.1	BT_Cry1Da1	domain3	domain1	major	1292	1636	1445	1789	0	600	624	1200	1227	1638	153	753	777	1353	1380	1791	1295	1624	1436	1765	0	603	627	1203	1233	1629	141	744	768	1344	1374	1770
2	NOV_Cry1Da1_84.8_ABK35074.1	BT_Cry1Da1	domain3	domain2	major	1292	1636	1445	1789	0	600	624	1200	1227	1638	153	753	777	1353	1380	1791	1295	1624	1436	1765	0	603	627	1203	1233	1629	141	744	768	1344	1374	1770
2	NOV_Cry1Da1_84.8_ABK35074.1	NOV_Cry1Ad2_87.7_AIW52617.1	domain3	domain1	major	1292	1636	1445	1789	0	600	624	1200	1227	1638	153	753	777	1353	1380	1791	1322	1666	1466	1810	0	603	627	1218	1224	1668	144	747	771	1362	1368	1812
2	NOV_Cry1Da1_84.8_ABK35074.1	BT_Cry1Ai1	domain3	domain1	major	1292	1636	1445	1789	0	600	624	1200	1227	1638	153	753	777	1353	1380	1791	1319	1669	1463	1813	0	603	627	1230	1254	1671	144	747	771	1374	1398	1815
2	NOV_Cry1Da1_84.8_ABK35074.1	BT_Cry1Db1	domain3	domain1	major	1292	1636	1445	1789	0	600	624	1200	1227	1638	153	753	777	1353	1380	1791	1295	1624	1436	1765	0	603	627	1203	1233	1629	141	744	768	1344	1374	1770
2	NOV_Cry1Da1_84.8_ABK35074.1	NOV_Cry1Da1_83.2_AIW52615.1	domain3	domain1	major	1292	1636	1445	1789	0	600	624	1200	1227	1638	153	753	777	1353	1380	1791	1295	1627	1436	1768	0	603	627	1200	1233	1632	141	744	768	1341	1374	1773
2	NOV_Cry1Da1_84.8_ABK35074.1	BT_Cry1A-like	domain3	domain1	major	1292	1636	1445	1789	0	600	624	1200	1227	1638	153	753	777	1353	1380	1791	1310	1654	1454	1798	0	366	714	1209	1215	1656	144	510	858	1353	1359	1800
2	NOV_Cry1Da1_84.8_ABK35074.1	BT_Cry1Ab12	domain3	domain1	major	1292	1636	1445	1789	0	600	624	1200	1227	1638	153	753	777	1353	1380	1791	1325	1669	1469	1813	0	603	627	1224	1230	1671	144	747	771	1368	1374	1815
2	NOV_Cry1Da1_84.8_ABK35074.1	BT_Cry1Eb1	domain3	domain1	major	1292	1636	1445	1789	0	600	624	1200	1227	1638	153	753	777	1353	1380	1791	1301	1642	1445	1786	0	597	624	1209	1236	1644	144	741	768	1353	1380	1788
2	NOV_Cry1Da1_84.8_ABK35074.1	BT_Cry1Ea10	domain3	domain1	major	1292	1636	1445	1789	0	600	624	1200	1227	1638	153	753	777	1353	1380	1791	1303	1647	1448	1792	0	603	627	1215	1245	1647	141	744	768	1356	1386	1788
2	NOV_Cry1Da1_84.8_ABK35074.1	BT_Cry1Ah2	domain3	domain1	major	1292	1636	1445	1789	0	600	624	1200	1227	1638	153	753	777	1353	1380	1791	1319	1669	1463	1813	0	603	627	1230	1254	1671	144	747	771	1374	1398	1815
2	NOV_Cry1Da1_84.8_ABK35074.1	NOV_Cry1Ab12_91.4_AAK14338.1	domain3	domain1	major	1292	1636	1445	1789	0	600	624	1200	1227	1638	153	753	777	1353	1380	1791	1325	1669	1463	1807	0	603	627	1224	1230	1671	138	741	765	1362	1368	1809
2	NOV_Cry1Da1_84.8_ABK35074.1	BT_Cry1Ab2	domain3	domain1	major	1292	1636	1445	1789	0	600	624	1200	1227	1638	153	753	777	1353	1380	1791	1331	1672	1475	1816	0	603	627	1239	1242	1674	144	747	771	1383	1386	1818
2	NOV_Cry1Da1_84.8_ABK35074.1	NOV_Cry1Ea10_93.2_AAX86871.1	domain3	domain1	major	1292	1636	1445	1789	0	600	624	1200	1227	1638	153	753	777	1353	1380	1791	1306	1650	1337	1681	0	606	630	1218	1248	1650	27	633	657	1245	1275	1677
2	NOV_Cry1Da1_84.8_ABK35074.1	NOV_Cry1Ac23_90.7_CAQ03747.1	domain3	domain1	major	1292	1636	1445	1789	0	600	624	1200	1227	1638	153	753	777	1353	1380	1791	1348	1749	1865	2266	0	501	702	1311	1332	1749	468	969	1170	1779	1800	2217
3	NOV_Cry7Ba1_84.3_AFI42043.1	BT_Cry7Ac1	domain3	domain3	minor	1391	1711	1640	1959	0	597	627	1263	1287	1710	249	846	876	1512	1536	1959	1352	1671	1583	1902	0	597	621	1224	1254	1674	231	828	852	1455	1485	1905
3	NOV_Cry7Ba1_84.3_AFI42043.1	BT_Cry7Ba1	domain3	domain1	major	1391	1711	1640	1959	0	597	627	1263	1287	1710	249	846	876	1512	1536	1959	1388	1698	1637	1947	0	597	627	1260	1284	1698	249	846	876	1509	1533	1947
3	NOV_Cry7Ba1_84.3_AFI42043.1	BT_Cry7Ba1	domain3	domain2	major	1391	1711	1640	1959	0	597	627	1263	1287	1710	249	846	876	1512	1536	1959	1388	1698	1637	1947	0	597	627	1260	1284	1698	249	846	876	1509	1533	1947
6	BT_Cry24Ca1	BT_Cry40Ba1	domain3	domain3	minor	1369	1732	1609	1971	0	633	657	1305	1332	1731	240	873	897	1545	1572	1971	1336	1698	1549	1911	0	645	669	1269	1305	1701	213	858	882	1482	1518	1914
6	BT_Cry24Ca1	BT_Cry24Da1	domain3	domain1	major	1369	1732	1609	1971	0	633	657	1305	1332	1731	240	873	897	1545	1572	1971	1369	1743	1612	1986	0	633	657	1305	1332	1746	243	876	900	1548	1575	1989
6	BT_Cry24Ca1	BT_Cry24Da1	domain3	domain2	major	1369	1732	1609	1971	0	633	657	1305	1332	1731	240	873	897	1545	1572	1971	1369	1743	1612	1986	0	633	657	1305	1332	1746	243	876	900	1548	1575	1989
8	BT_Cry71Aa1	BT_Cry72Aa1	domain3	domain3	minor	1370	1774	1622	2025	0	600	624	1275	1305	1773	252	852	876	1527	1557	2025	1313	1716	1535	1938	0	576	600	1215	1251	1716	222	798	822	1437	1473	1938
8	BT_Cry71Aa1	NOV_Cry71Aa1_65.9_PEU78325.1	domain3	domain1	major	1370	1774	1622	2025	0	600	624	1275	1305	1773	252	852	876	1527	1557	2025	1260	1632	1266	1638	0	519	543	1194	1221	1632	0	519	543	1194	1221	1632
8	BT_Cry71Aa1	NOV_Cry71Aa1_65.9_PEU78325.1	domain3	domain2	major	1370	1774	1622	2025	0	600	624	1275	1305	1773	252	852	876	1527	1557	2025	1260	1632	1266	1638	0	519	543	1194	1221	1632	0	519	543	1194	1221	1632
10	NOV_Cry7Ca1_86.8_AGM39664.1	BT_Cry7Ha1	domain3	domain3	minor	1300	1643	1519	1862	0	609	633	1269	1299	1731	219	828	852	1488	1518	1950	1237	1580	1546	1889	0	594	618	1209	1233	1668	309	903	927	1518	1542	1977
10	NOV_Cry7Ca1_86.8_AGM39664.1	NOV_Cry7Ca1_99.7_ABR67863.2	domain3	domain1	major	1300	1643	1519	1862	0	609	633	1269	1299	1731	219	828	852	1488	1518	1950	1300	1610	1519	1829	0	609	633	1269	1296	1698	219	828	852	1488	1515	1917
10	NOV_Cry7Ca1_86.8_AGM39664.1	NOV_Cry7Ca1_99.7_ABR67863.2	domain3	domain2	major	1300	1643	1519	1862	0	609	633	1269	1299	1731	219	828	852	1488	1518	1950	1300	1610	1519	1829	0	609	633	1269	1296	1698	219	828	852	1488	1515	1917
13	NOV_Cry4Ba1_63.7_AJW76684.1	BT_Cry50Ba1	domain3	domain3	minor	1285	1714	1549	1977	0	618	666	1221	1251	1713	264	882	930	1485	1515	1977	1282	1710	1528	1956	0	606	654	1218	1239	1710	243	849	897	1461	1482	1953
13	NOV_Cry4Ba1_63.7_AJW76684.1	NOV_Cry4Ba1_63.8_OUB35623.1	domain3	domain1	major	1285	1714	1549	1977	0	618	666	1221	1251	1713	264	882	930	1485	1515	1977	1294	1737	1552	1995	0	618	666	1230	1260	1737	258	876	924	1488	1518	1995
13	NOV_Cry4Ba1_63.7_AJW76684.1	NOV_Cry4Ba1_63.8_OUB35623.1	domain3	domain2	major	1285	1714	1549	1977	0	618	666	1221	1251	1713	264	882	930	1485	1515	1977	1294	1737	1552	1995	0	618	666	1230	1260	1737	258	876	924	1488	1518	1995
14	BT_Cry1Cb1	BT_Cry1Bf1	domain3	domain3	minor	1224	1557	1365	1698	0	603	636	1224	1251	1659	141	744	777	1365	1392	1800	1260	1593	1398	1731	0	603	627	1260	1284	1695	138	741	765	1398	1422	1833
14	BT_Cry1Cb1	BT_Cry1Bg1	domain3	domain3	minor	1224	1557	1365	1698	0	603	636	1224	1251	1659	141	744	777	1365	1392	1800	1260	1593	1497	1830	0	603	627	1260	1284	1695	237	840	864	1497	1521	1932
14	BT_Cry1Cb1	BT_Cry1Eb1	domain3	domain3	minor	1224	1557	1365	1698	0	603	636	1224	1251	1659	141	744	777	1365	1392	1800	1209	1542	1353	1686	0	597	624	1209	1236	1644	144	741	768	1353	1380	1788
14	BT_Cry1Cb1	BT_Cry1Be1	domain3	domain3	minor	1224	1557	1365	1698	0	603	636	1224	1251	1659	141	744	777	1365	1392	1800	1257	1590	1395	1728	0	603	627	1257	1281	1692	138	741	765	1395	1419	1830
14	BT_Cry1Cb1	BT_Cry1Ca11	domain3	domain1	major	1224	1557	1365	1698	0	603	636	1224	1251	1659	141	744	777	1365	1392	1800	1224	1578	1365	1719	0	603	636	1224	1254	1695	141	744	777	1365	1395	1836
14	BT_Cry1Cb1	BT_Cry1Ca11	domain3	domain2	major	1224	1557	1365	1698	0	603	636	1224	1251	1659	141	744	777	1365	1392	1800	1224	1578	1365	1719	0	603	636	1224	1254	1695	141	744	777	1365	1395	1836
17	BT_Cry1Fa1	BT_Cry1Ka2	domain3	domain3	minor	1231	1660	1369	1797	0	603	627	1218	1248	1659	138	741	765	1356	1386	1797	1255	1683	1396	1824	0	603	627	1245	1269	1683	138	741	765	1383	1407	1821
17	BT_Cry1Fa1	BT_Cry1Ig1	domain3	domain3	minor	1231	1660	1369	1797	0	603	627	1218	1248	1659	138	741	765	1356	1386	1797	1267	1695	1498	1926	0	603	627	1257	1275	1695	228	831	855	1485	1503	1923
17	BT_Cry1Fa1	BT_Cry1Fb1	domain3	domain1	major	1231	1660	1369	1797	0	603	627	1218	1248	1659	138	741	765	1356	1386	1797	1228	1653	1369	1794	0	603	627	1218	1248	1653	138	741	765	1356	1386	1791
17	BT_Cry1Fa1	BT_Cry1Fb1	domain3	domain2	major	1231	1660	1369	1797	0	603	627	1218	1248	1659	138	741	765	1356	1386	1797	1228	1653	1369	1794	0	603	627	1218	1248	1653	138	741	765	1356	1386	1791
19	BT_Cry9Ga1	BT_Cry1Ga2	domain3	domain3	minor	1336	1744	1555	1962	0	636	660	1302	1335	1743	219	855	879	1521	1554	1962	1225	1635	1366	1776	0	591	615	1194	1218	1635	141	732	756	1335	1359	1776
19	BT_Cry9Ga1	BT_Cry1Gb1	domain3	domain3	minor	1336	1744	1555	1962	0	636	660	1302	1335	1743	219	855	879	1521	1554	1962	1234	1641	1372	1779	0	591	615	1203	1227	1641	138	729	753	1341	1365	1779
19	BT_Cry9Ga1	BT_Cry9Aa1	domain3	domain1	major	1336	1744	1555	1962	0	636	660	1302	1335	1743	219	855	879	1521	1554	1962	1336	1740	1555	1959	0	636	660	1302	1329	1740	219	855	879	1521	1548	1959
19	BT_Cry9Ga1	BT_Cry9Aa1	domain3	domain2	major	1336	1744	1555	1962	0	636	660	1302	1335	1743	219	855	879	1521	1554	1962	1336	1740	1555	1959	0	636	660	1302	1329	1740	219	855	879	1521	1548	1959
22	BT_Cry8Pa1	NOV_Cry8Ba1_88.6_AEP25412.1	domain2	domain2	minor	542	1185	800	1443	0	603	627	1290	1296	1713	258	861	885	1548	1554	1971	545	1188	803	1446	0	606	630	1269	1299	1614	258	864	888	1527	1557	1872
22	BT_Cry8Pa1	BT_Cry8Ja1	domain2	domain1	major	542	1185	800	1443	0	603	627	1290	1296	1713	258	861	885	1548	1554	1971	536	1164	800	1428	0	597	621	1233	1275	1713	264	861	885	1497	1539	1977
22	BT_Cry8Pa1	BT_Cry8Ea2	domain2	domain1	major	542	1185	800	1443	0	603	627	1290	1296	1713	258	861	885	1548	1554	1971	536	1164	800	1428	0	597	621	1233	1257	1683	264	861	885	1497	1521	1947
23	BT_Cry52Ba1	BT_Cry52Ca1	domain3	domain3	minor	1363	1702	1612	1950	0	609	651	1287	1311	1701	249	858	900	1536	1560	1950	1318	1656	1561	1899	0	591	630	1236	1266	1662	243	834	873	1479	1509	1905
23	BT_Cry52Ba1	BT_Cry40Aa1	domain3	domain3	minor	1363	1702	1612	1950	0	609	651	1287	1311	1701	249	858	900	1536	1560	1950	1366	1701	1516	1851	0	678	702	1284	1320	1707	150	828	852	1434	1470	1857
23	BT_Cry52Ba1	NOV_Cry52Ca1_62.9_AZJ24464.1	domain3	domain1	major	1363	1702	1612	1950	0	609	651	1287	1311	1701	249	858	900	1536	1560	1950	1302	1668	1551	1917	0	582	621	1227	1251	1671	249	831	870	1476	1500	1920
23	BT_Cry52Ba1	NOV_Cry52Ca1_62.9_AZJ24464.1	domain3	domain2	major	1363	1702	1612	1950	0	609	651	1287	1311	1701	249	858	900	1536	1560	1950	1302	1668	1551	1917	0	582	621	1227	1251	1671	249	831	870	1476	1500	1920
23	BT_Cry52Ba1	BT_Cry52Ca1	domain3	domain2	major	1363	1702	1612	1950	0	609	651	1287	1311	1701	249	858	900	1536	1560	1950	1318	1656	1561	1899	0	591	630	1236	1266	1662	243	834	873	1479	1509	1905
24	BT_Cry1Ig1	BT_Cry1Ka2	domain3	domain3	minor	1263	1696	1491	1923	0	603	627	1257	1275	1695	228	831	855	1485	1503	1923	1251	1683	1389	1821	0	603	627	1245	1269	1683	138	741	765	1383	1407	1821
24	BT_Cry1Ig1	NOV_Cry1Ie5_79.3_PQQ47595.1	domain3	domain1	major	1263	1696	1491	1923	0	603	627	1257	1275	1695	228	831	855	1485	1503	1923	1263	1692	1491	1920	0	603	627	1257	1287	1695	228	831	855	1485	1515	1923
24	BT_Cry1Ig1	BT_Cry1Ia18	domain3	domain1	major	1263	1696	1491	1923	0	603	627	1257	1275	1695	228	831	855	1485	1503	1923	1263	1695	1491	1923	0	603	627	1257	1287	1698	228	831	855	1485	1515	1926
24	BT_Cry1Ig1	BT_Cry1Ie4	domain3	domain1	major	1263	1696	1491	1923	0	603	627	1257	1275	1695	228	831	855	1485	1503	1923	1269	1701	1497	1929	0	603	627	1263	1293	1704	228	831	855	1491	1521	1932
24	BT_Cry1Ig1	BT_Cry1Ic1	domain3	domain1	major	1263	1696	1491	1923	0	603	627	1257	1275	1695	228	831	855	1485	1503	1923	1257	1689	1491	1923	0	597	621	1251	1281	1692	234	831	855	1485	1515	1926
24	BT_Cry1Ig1	BT_Cry1Ia11	domain3	domain1	major	1263	1696	1491	1923	0	603	627	1257	1275	1695	228	831	855	1485	1503	1923	1263	1695	1491	1923	0	603	627	1257	1287	1698	228	831	855	1485	1515	1926
24	BT_Cry1Ig1	BT_Cry1Ia11	domain3	domain2	major	1263	1696	1491	1923	0	603	627	1257	1275	1695	228	831	855	1485	1503	1923	1263	1695	1491	1923	0	603	627	1257	1287	1698	228	831	855	1485	1515	1926
27	NOV_Cry41Ba2_43.6_BAD35163.1	NOV_Cry32Ma1_57.7_AXY11484.1	domain3	domain3	minor	1321	1786	1570	2034	0	702	726	1335	1359	1785	249	951	975	1584	1608	2034	1327	1788	1567	2028	0	720	750	1341	1362	1788	240	960	990	1581	1602	2028
27	NOV_Cry41Ba2_43.6_BAD35163.1	NOV_Cry41Ba2_47.9_BAD35157.1	domain3	domain1	major	1321	1786	1570	2034	0	702	726	1335	1359	1785	249	951	975	1584	1608	2034	1321	1767	1570	2016	0	702	726	1335	1365	1767	249	951	975	1584	1614	2016
27	NOV_Cry41Ba2_43.6_BAD35163.1	NOV_Cry41Ba2_47.9_BAD35157.1	domain3	domain2	major	1321	1786	1570	2034	0	702	726	1335	1359	1785	249	951	975	1584	1608	2034	1321	1767	1570	2016	0	702	726	1335	1365	1767	249	951	975	1584	1614	2016
28	BT_Cry7Cb1	NOV_Cry7Cb1_60.4_OTY00887.1	domain3	domain3	minor	1282	1759	1630	2106	0	609	633	1296	1326	1758	348	957	981	1644	1674	2106	1276	1749	1516	1989	0	630	654	1290	1320	1749	240	870	894	1530	1560	1989
28	BT_Cry7Cb1	NOV_Cry7Ea2_99.9_AFI42038.1	domain3	domain2	major	1282	1759	1630	2106	0	609	633	1296	1326	1758	348	957	981	1644	1674	2106	1252	1719	1498	1965	0	609	633	1272	1293	1719	240	849	873	1512	1533	1959
28	BT_Cry7Cb1	NOV_Cry7Ca1_86.8_AGM39664.1	domain3	domain1	major	1282	1759	1630	2106	0	609	633	1296	1326	1758	348	957	981	1644	1674	2106	1255	1731	1477	1953	0	609	633	1269	1299	1731	219	828	852	1488	1518	1950
28	BT_Cry7Cb1	NOV_Cry7Ca1_86.8_AGM39664.1	domain3	domain2	major	1282	1759	1630	2106	0	609	633	1296	1326	1758	348	957	981	1644	1674	2106	1255	1731	1477	1953	0	609	633	1269	1299	1731	219	828	852	1488	1518	1950
28	BT_Cry7Cb1	NOV_Cry7Ca1_99.7_ABR67863.2	domain3	domain1	major	1282	1759	1630	2106	0	609	633	1296	1326	1758	348	957	981	1644	1674	2106	1255	1698	1477	1920	0	609	633	1269	1296	1698	219	828	852	1488	1515	1917
28	BT_Cry7Cb1	NOV_Cry7Ca1_99.7_ABR67863.2	domain3	domain2	major	1282	1759	1630	2106	0	609	633	1296	1326	1758	348	957	981	1644	1674	2106	1255	1698	1477	1920	0	609	633	1269	1296	1698	219	828	852	1488	1515	1917
29	BT_Cry50Ba1;BT_Cry4Ba1;BT_Cry4Ba3;BT_Cry50Aa1;NOV_Cry4Ba1_63.8_OUB35623.1	BT_Cry30Aa1	domain3	domain3	minor	1295	1711	1538	1953	0	606	654	1218	1239	1710	243	849	897	1461	1482	1953	1349	1761	1616	2028	0	630	654	1275	1305	1764	267	897	921	1542	1572	2031
29	BT_Cry50Ba1;BT_Cry4Ba1;BT_Cry4Ba3;BT_Cry50Aa1;NOV_Cry4Ba1_63.8_OUB35623.1	BT_Cry30Ga1	domain3	domain3	minor	1295	1711	1538	1953	0	606	654	1218	1239	1710	243	849	897	1461	1482	1953	1277	1692	1541	1956	0	633	657	1200	1233	1695	264	897	921	1464	1497	1959
29	BT_Cry50Ba1;BT_Cry4Ba1;BT_Cry4Ba3;BT_Cry50Aa1;NOV_Cry4Ba1_63.8_OUB35623.1	BT_Cry30Fa1	domain3	domain3	minor	1295	1711	1538	1953	0	606	654	1218	1239	1710	243	849	897	1461	1482	1953	1343	1758	1610	2025	0	633	657	1269	1299	1761	267	900	924	1536	1566	2028
29	BT_Cry50Ba1;BT_Cry4Ba1;BT_Cry4Ba3;BT_Cry50Aa1;NOV_Cry4Ba1_63.8_OUB35623.1	BT_Cry30Ea1	domain3	domain3	minor	1295	1711	1538	1953	0	606	654	1218	1239	1710	243	849	897	1461	1482	1953	1346	1758	1616	2028	0	627	645	1269	1302	1761	270	897	915	1539	1572	2031
29	BT_Cry50Ba1;BT_Cry4Ba1;BT_Cry4Ba3;BT_Cry50Aa1;NOV_Cry4Ba1_63.8_OUB35623.1	BT_Cry30Ca1	domain3	domain3	minor	1295	1711	1538	1953	0	606	654	1218	1239	1710	243	849	897	1461	1482	1953	1349	1764	1613	2028	0	633	651	1281	1305	1767	264	897	915	1545	1569	2031
29	BT_Cry50Ba1;BT_Cry4Ba1;BT_Cry4Ba3;BT_Cry50Aa1;NOV_Cry4Ba1_63.8_OUB35623.1	BT_Cry19Aa1	domain3	domain1	major	1295	1711	1538	1953	0	606	654	1218	1239	1710	243	849	897	1461	1482	1953	1304	1677	1574	1947	0	609	633	1239	1269	1677	261	870	894	1500	1530	1938
29	BT_Cry50Ba1;BT_Cry4Ba1;BT_Cry4Ba3;BT_Cry50Aa1;NOV_Cry4Ba1_63.8_OUB35623.1	BT_Cry19Aa1	domain3	domain2	major	1295	1711	1538	1953	0	606	654	1218	1239	1710	243	849	897	1461	1482	1953	1304	1677	1574	1947	0	609	633	1239	1269	1677	261	870	894	1500	1530	1938
32	BT_Cry7Bb1	BT_Cry7Ac1	domain3	domain3	minor	1397	1700	1718	2021	0	603	633	1266	1290	1716	321	924	954	1587	1611	2037	1352	1655	1583	1886	0	597	621	1224	1254	1674	231	828	852	1455	1485	1905
32	BT_Cry7Bb1	NOV_Cry7Ba1_84.3_AFI42043.1	domain3	domain3	minor	1397	1700	1718	2021	0	603	633	1266	1290	1716	321	924	954	1587	1611	2037	1391	1694	1640	1943	0	597	627	1263	1287	1710	249	846	876	1512	1536	1959
32	BT_Cry7Bb1	BT_Cry7Ba1	domain3	domain1	major	1397	1700	1718	2021	0	603	633	1266	1290	1716	321	924	954	1587	1611	2037	1388	1682	1637	1931	0	597	627	1260	1284	1698	249	846	876	1509	1533	1947
32	BT_Cry7Bb1	BT_Cry7Ba1	domain3	domain2	major	1397	1700	1718	2021	0	603	633	1266	1290	1716	321	924	954	1587	1611	2037	1388	1682	1637	1931	0	597	627	1260	1284	1698	249	846	876	1509	1533	1947
32	BT_Cry7Bb1	NOV_Cry7Ba1_84.3_AFI42043.1	domain3	domain1	major	1397	1700	1718	2021	0	603	633	1266	1290	1716	321	924	954	1587	1611	2037	1391	1694	1640	1943	0	597	627	1263	1287	1710	249	846	876	1512	1536	1959
32	BT_Cry7Bb1	NOV_Cry7Ba1_84.3_AFI42043.1	domain3	domain2	major	1397	1700	1718	2021	0	603	633	1266	1290	1716	321	924	954	1587	1611	2037	1391	1694	1640	1943	0	597	627	1263	1287	1710	249	846	876	1512	1536	1959
34	NOV_Cry14Ab1_42.4_PGW46196.1	NOV_Cry14Aa1_44.0_PGW42274.1	domain1	domain1	minor	1	738	289	1026	0	678	696	1365	1371	1830	288	966	984	1653	1659	2118	1	738	289	1026	0	678	696	1374	1380	1806	288	966	984	1662	1668	2094
34	NOV_Cry14Ab1_42.4_PGW46196.1	NOV_Cry14Aa1_41.1_PGW46198.1	domain1	domain2	major	1	738	289	1026	0	678	696	1365	1371	1830	288	966	984	1653	1659	2118	0	752	481	1233	0	684	702	1371	1377	1836	489	1173	1191	1860	1866	2325
34	NOV_Cry14Ab1_42.4_PGW46196.1	NOV_Cry14Aa1_41.1_PGW46198.1	domain1	domain3	major	1	738	289	1026	0	678	696	1365	1371	1830	288	966	984	1653	1659	2118	0	752	481	1233	0	684	702	1371	1377	1836	489	1173	1191	1860	1866	2325
36	BT_Cry32Wa1	BT_Cry32Pa1	domain3	domain3	minor	1291	1707	1531	1947	0	684	714	1281	1314	1710	240	924	954	1521	1554	1950	1330	1752	1579	2001	0	693	717	1323	1353	1752	249	942	966	1572	1602	2001
36	BT_Cry32Wa1	BT_Cry32Ma1	domain3	domain1	major	1291	1707	1531	1947	0	684	714	1281	1314	1710	240	924	954	1521	1554	1950	1291	1725	1531	1965	0	684	714	1281	1308	1725	240	924	954	1521	1548	1965
36	BT_Cry32Wa1	BT_Cry32Ma1	domain3	domain2	major	1291	1707	1531	1947	0	684	714	1281	1314	1710	240	924	954	1521	1554	1950	1291	1725	1531	1965	0	684	714	1281	1308	1725	240	924	954	1521	1548	1965
36	BT_Cry32Wa1	BT_Cry32Mb1	domain3	domain1	major	1291	1707	1531	1947	0	684	714	1281	1314	1710	240	924	954	1521	1554	1950	1291	1716	1531	1956	0	684	714	1281	1308	1716	240	924	954	1521	1548	1956
36	BT_Cry32Wa1	BT_Cry32Mb1	domain3	domain2	major	1291	1707	1531	1947	0	684	714	1281	1314	1710	240	924	954	1521	1554	1950	1291	1716	1531	1956	0	684	714	1281	1308	1716	240	924	954	1521	1548	1956
37	BT_Cry52Ca1	BT_Cry40Aa1	domain3	domain3	minor	1331	1663	1574	1905	0	591	630	1236	1266	1662	243	834	873	1479	1509	1905	1379	1707	1529	1857	0	678	702	1284	1320	1707	150	828	852	1434	1470	1857
37	BT_Cry52Ca1	NOV_Cry52Ca1_62.9_AZJ24464.1	domain3	domain1	major	1331	1663	1574	1905	0	591	630	1236	1266	1662	243	834	873	1479	1509	1905	1310	1671	1562	1923	0	582	621	1227	1251	1671	249	831	870	1476	1500	1920
37	BT_Cry52Ca1	NOV_Cry52Ca1_62.9_AZJ24464.1	domain3	domain2	major	1331	1663	1574	1905	0	591	630	1236	1266	1662	243	834	873	1479	1509	1905	1310	1671	1562	1923	0	582	621	1227	1251	1671	249	831	870	1476	1500	1920
37	BT_Cry52Ca1	BT_Cry52Ba1	domain3	domain1	major	1331	1663	1574	1905	0	591	630	1236	1266	1662	243	834	873	1479	1509	1905	1370	1701	1625	1956	0	609	651	1287	1311	1701	249	858	900	1536	1560	1950
37	BT_Cry52Ca1	BT_Cry52Aa1	domain3	domain1	major	1331	1663	1574	1905	0	591	630	1236	1266	1662	243	834	873	1479	1509	1905	1382	1704	1640	1962	0	615	657	1296	1320	1704	255	870	912	1551	1575	1959
38	BT_Cry59Ba1	BT_Cry40Da1	domain1	domain1	minor	1	684	220	903	0	648	672	1305	1338	1722	219	867	891	1524	1557	1941	4	678	223	897	0	642	666	1257	1284	1668	219	861	885	1476	1503	1887
38	BT_Cry59Ba1	NOV_Cry40Da1_77.3_ARJ25823.1	domain1	domain1	minor	1	684	220	903	0	648	672	1305	1338	1722	219	867	891	1524	1557	1941	1	675	223	897	0	639	663	1251	1278	1659	222	861	885	1473	1500	1881
38	BT_Cry59Ba1	NOV_Cry40Da1_81.5_AIN76756.1	domain1	domain1	minor	1	684	220	903	0	648	672	1305	1338	1722	219	867	891	1524	1557	1941	1	675	223	897	0	639	663	1248	1281	1659	222	861	885	1470	1503	1881
38	BT_Cry59Ba1	BT_Cry40Ca1	domain1	domain1	minor	1	684	220	903	0	648	672	1305	1338	1722	219	867	891	1524	1557	1941	1	678	226	903	0	642	666	1248	1272	1659	225	867	891	1473	1497	1884
38	BT_Cry59Ba1	NOV_Cry40Da1_66.9_PEU78339.1	domain1	domain1	minor	1	684	220	903	0	648	672	1305	1338	1722	219	867	891	1524	1557	1941	1	660	220	879	0	624	648	1242	1266	1656	219	843	867	1461	1485	1875
38	BT_Cry59Ba1	NOV_Cry40Da1_65.0_CAH33957.1	domain1	domain1	minor	1	684	220	903	0	648	672	1305	1338	1722	219	867	891	1524	1557	1941	1	660	220	879	0	624	648	1236	1266	1668	219	843	867	1455	1485	1887
38	BT_Cry59Ba1	BT_Cry40Ba1	domain1	domain1	minor	1	684	220	903	0	648	672	1305	1338	1722	219	867	891	1524	1557	1941	7	681	220	894	0	645	669	1269	1305	1701	213	858	882	1482	1518	1914
38	BT_Cry59Ba1	BT_Cry59Aa1	domain1	domain2	major	1	684	220	903	0	648	672	1305	1338	1722	219	867	891	1524	1557	1941	0	656	220	876	0	573	597	1230	1263	1647	267	840	864	1497	1530	1914
38	BT_Cry59Ba1	BT_Cry59Aa1	domain1	domain3	major	1	684	220	903	0	648	672	1305	1338	1722	219	867	891	1524	1557	1941	0	656	220	876	0	573	597	1230	1263	1647	267	840	864	1497	1530	1914
39	BT_Cry52Aa1	BT_Cry52Ca1	domain3	domain3	minor	1380	1705	1635	1959	0	615	657	1296	1320	1704	255	870	912	1551	1575	1959	1320	1659	1563	1902	0	591	630	1236	1266	1662	243	834	873	1479	1509	1905
39	BT_Cry52Aa1	BT_Cry40Aa1	domain3	domain3	minor	1380	1705	1635	1959	0	615	657	1296	1320	1704	255	870	912	1551	1575	1959	1374	1704	1524	1854	0	678	702	1284	1320	1707	150	828	852	1434	1470	1857
39	BT_Cry52Aa1	NOV_Cry52Ca1_62.9_AZJ24464.1	domain3	domain1	major	1380	1705	1635	1959	0	615	657	1296	1320	1704	255	870	912	1551	1575	1959	1308	1671	1557	1920	0	582	621	1227	1251	1671	249	831	870	1476	1500	1920
39	BT_Cry52Aa1	NOV_Cry52Ca1_62.9_AZJ24464.1	domain3	domain2	major	1380	1705	1635	1959	0	615	657	1296	1320	1704	255	870	912	1551	1575	1959	1308	1671	1557	1920	0	582	621	1227	1251	1671	249	831	870	1476	1500	1920
39	BT_Cry52Aa1	BT_Cry52Ca1	domain3	domain2	major	1380	1705	1635	1959	0	615	657	1296	1320	1704	255	870	912	1551	1575	1959	1320	1659	1563	1902	0	591	630	1236	1266	1662	243	834	873	1479	1509	1905
44	BT_Cry9Ee1	BT_Cry9Bb1	domain3	domain3	minor	1234	1705	1492	1962	0	615	642	1260	1284	1704	258	873	900	1518	1542	1962	1249	1719	1513	1983	0	600	624	1275	1305	1722	264	864	888	1539	1569	1986
44	BT_Cry9Ee1	BT_Cry9Ed1	domain3	domain1	major	1234	1705	1492	1962	0	615	642	1260	1284	1704	258	873	900	1518	1542	1962	1234	1698	1492	1956	0	615	642	1260	1263	1698	258	873	900	1518	1521	1956
44	BT_Cry9Ee1	BT_Cry9Ed1	domain3	domain2	major	1234	1705	1492	1962	0	615	642	1260	1284	1704	258	873	900	1518	1542	1962	1234	1698	1492	1956	0	615	642	1260	1263	1698	258	873	900	1518	1521	1956
44	BT_Cry9Ee1	BT_Cry9Ec1	domain3	domain1	major	1234	1705	1492	1962	0	615	642	1260	1284	1704	258	873	900	1518	1542	1962	1234	1698	1492	1956	0	615	642	1260	1287	1698	258	873	900	1518	1545	1956
44	BT_Cry9Ee1	BT_Cry9Ec1	domain3	domain2	major	1234	1705	1492	1962	0	615	642	1260	1284	1704	258	873	900	1518	1542	1962	1234	1698	1492	1956	0	615	642	1260	1287	1698	258	873	900	1518	1545	1956
45	NOV_Cry40Da1_65.0_CAH33957.1	NOV_Cry40Da1_66.9_PEU78339.1	domain1	domain1	minor	1	549	220	768	0	624	648	1236	1266	1668	219	843	867	1455	1485	1887	1	549	220	768	0	624	648	1242	1266	1656	219	843	867	1461	1485	1875
45	NOV_Cry40Da1_65.0_CAH33957.1	NOV_Cry40Da1_81.5_AIN76756.1	domain1	domain2	major	1	549	220	768	0	624	648	1236	1266	1668	219	843	867	1455	1485	1887	1	564	223	786	0	639	663	1248	1281	1659	222	861	885	1470	1503	1881
45	NOV_Cry40Da1_65.0_CAH33957.1	BT_Cry40Da1	domain1	domain2	major	1	549	220	768	0	624	648	1236	1266	1668	219	843	867	1455	1485	1887	4	567	223	786	0	642	666	1257	1284	1668	219	861	885	1476	1503	1887
45	NOV_Cry40Da1_65.0_CAH33957.1	NOV_Cry40Da1_77.3_ARJ25823.1	domain1	domain2	major	1	549	220	768	0	624	648	1236	1266	1668	219	843	867	1455	1485	1887	1	564	223	786	0	639	663	1251	1278	1659	222	861	885	1473	1500	1881
47	BT_Cry2Ai1	BT_Cry2Ac10	domain1	domain1	minor	1	502	202	703	0	579	594	1209	1248	1671	201	780	795	1410	1449	1872	1	502	202	703	0	579	594	1182	1221	1641	201	780	795	1383	1422	1842
47	BT_Cry2Ai1	BT_Cry2Aa13	domain1	domain2	major	1	502	202	703	0	579	594	1209	1248	1671	201	780	795	1410	1449	1872	1	502	202	703	0	579	594	1209	1248	1671	201	780	795	1410	1449	1872
47	BT_Cry2Ai1	BT_Cry2Aa13	domain1	domain3	major	1	502	202	703	0	579	594	1209	1248	1671	201	780	795	1410	1449	1872	1	502	202	703	0	579	594	1209	1248	1671	201	780	795	1410	1449	1872
49	NOV_Cry8Ab1_80.0_AMR06151.1	BT_Cry8Ra1	domain3	domain3	minor	1329	1729	1581	1980	0	603	627	1290	1314	1728	252	855	879	1542	1566	1980	1362	1764	1623	2025	0	624	651	1323	1353	1767	261	885	912	1584	1614	2028
49	NOV_Cry8Ab1_80.0_AMR06151.1	BT_Cry8Ab1	domain3	domain1	major	1329	1729	1581	1980	0	603	627	1290	1314	1728	252	855	879	1542	1566	1980	1332	1737	1590	1995	0	606	630	1293	1317	1737	258	864	888	1551	1575	1995
49	NOV_Cry8Ab1_80.0_AMR06151.1	BT_Cry8Ab1	domain3	domain2	major	1329	1729	1581	1980	0	603	627	1290	1314	1728	252	855	879	1542	1566	1980	1332	1737	1590	1995	0	606	630	1293	1317	1737	258	864	888	1551	1575	1995
51	BT_Cry8Fa2	BT_Cry8Ga1	domain3	domain3	minor	1366	1716	1627	1977	0	588	612	1275	1305	1719	261	849	873	1536	1566	1980	1345	1695	1609	1959	0	597	621	1260	1287	1695	264	861	885	1524	1551	1959
51	BT_Cry8Fa2	BT_Cry8Qa1	domain3	domain1	major	1366	1716	1627	1977	0	588	612	1275	1305	1719	261	849	873	1536	1566	1980	1375	1728	1639	1992	0	585	609	1269	1299	1731	264	849	873	1533	1563	1995
51	BT_Cry8Fa2	BT_Cry8Qa1	domain3	domain2	major	1366	1716	1627	1977	0	588	612	1275	1305	1719	261	849	873	1536	1566	1980	1375	1728	1639	1992	0	585	609	1269	1299	1731	264	849	873	1533	1563	1995
52	NOV_Cry9Ga1_57.2_PEU81077.1	NOV_Cry68Aa1_80.1_PEU91245.1	domain3	domain3	minor	1382	1707	1601	1926	0	633	657	1287	1320	1707	219	852	876	1506	1539	1926	1382	1722	1604	1944	0	633	675	1296	1329	1722	213	846	888	1509	1542	1935
52	NOV_Cry9Ga1_57.2_PEU81077.1	BT_Cry68Aa1	domain3	domain3	minor	1382	1707	1601	1926	0	633	657	1287	1320	1707	219	852	876	1506	1539	1926	1376	1716	1625	1965	0	627	669	1290	1323	1716	240	867	909	1530	1563	1956
52	NOV_Cry9Ga1_57.2_PEU81077.1	NOV_Cry68Aa1_74.8_WP_103592020.1	domain3	domain3	minor	1382	1707	1601	1926	0	633	657	1287	1320	1707	219	852	876	1506	1539	1926	1379	1719	1619	1959	0	630	693	1293	1326	1719	231	861	924	1524	1557	1950
52	NOV_Cry9Ga1_57.2_PEU81077.1	NOV_Cry9Ga1_58.0_AJS57594.1	domain3	domain1	major	1382	1707	1601	1926	0	633	657	1287	1320	1707	219	852	876	1506	1539	1926	1370	1695	1604	1929	0	630	654	1278	1287	1695	231	861	885	1509	1518	1926
52	NOV_Cry9Ga1_57.2_PEU81077.1	NOV_Cry9Ga1_58.0_AJS57594.1	domain3	domain2	major	1382	1707	1601	1926	0	633	657	1287	1320	1707	219	852	876	1506	1539	1926	1370	1695	1604	1929	0	630	654	1278	1287	1695	231	861	885	1509	1518	1926
53	BT_Cry1Jd1	BT_Cry1Ja1	domain3	domain2	major	1218	1639	1359	1779	0	603	627	1194	1218	1638	141	744	768	1335	1359	1779	1224	1635	1365	1776	0	603	627	1200	1230	1635	141	744	768	1341	1371	1776
53	BT_Cry1Jd1	BT_Cry1Jb1	domain3	domain1	major	1218	1639	1359	1779	0	603	627	1194	1218	1638	141	744	768	1335	1359	1779	1224	1638	1365	1779	0	603	627	1200	1221	1638	141	744	768	1341	1362	1779
53	BT_Cry1Jd1	BT_Cry1Jb1	domain3	domain2	major	1218	1639	1359	1779	0	603	627	1194	1218	1638	141	744	768	1335	1359	1779	1224	1638	1365	1779	0	603	627	1200	1221	1638	141	744	768	1341	1362	1779
56	BT_Cry9Ca1	BT_Cry9Ea10	domain1	domain3	major	1	510	259	768	0	606	633	1251	1281	1710	258	864	891	1509	1539	1968	1	519	259	777	0	615	642	1251	1272	1686	258	873	900	1509	1530	1944
56	BT_Cry9Ca1	BT_Cry1Jb1	domain1	domain3	major	1	510	259	768	0	606	633	1251	1281	1710	258	864	891	1509	1539	1968	0	509	139	648	0	603	627	1200	1221	1638	141	744	768	1341	1362	1779
56	BT_Cry9Ca1	BT_Cry9Ed1	domain1	domain2	major	1	510	259	768	0	606	633	1251	1281	1710	258	864	891	1509	1539	1968	1	519	259	777	0	615	642	1260	1263	1698	258	873	900	1518	1521	1956
56	BT_Cry9Ca1	BT_Cry9Ed1	domain1	domain3	major	1	510	259	768	0	606	633	1251	1281	1710	258	864	891	1509	1539	1968	1	519	259	777	0	615	642	1260	1263	1698	258	873	900	1518	1521	1956
56	BT_Cry9Ca1	BT_Cry9Ec1	domain1	domain2	major	1	510	259	768	0	606	633	1251	1281	1710	258	864	891	1509	1539	1968	1	519	259	777	0	615	642	1260	1287	1698	258	873	900	1518	1545	1956
56	BT_Cry9Ca1	BT_Cry9Ec1	domain1	domain3	major	1	510	259	768	0	606	633	1251	1281	1710	258	864	891	1509	1539	1968	1	519	259	777	0	615	642	1260	1287	1698	258	873	900	1518	1545	1956
60	BT_Cry32Ha1;BT_Cry32Hb1	BT_Cry32Ka1	domain3	domain3	minor	1446	1756	1704	2013	0	639	663	1314	1341	1755	258	897	921	1572	1599	2013	1491	1809	1734	2052	0	675	699	1356	1386	1812	243	918	942	1599	1629	2055
60	BT_Cry32Ha1;BT_Cry32Hb1	BT_Cry32Oa1	domain3	domain1	major	1446	1756	1704	2013	0	639	663	1314	1341	1755	258	897	921	1572	1599	2013	1458	1791	1719	2052	0	639	663	1323	1329	1791	261	900	924	1584	1590	2052
60	BT_Cry32Ha1;BT_Cry32Hb1	BT_Cry32Oa1	domain3	domain2	major	1446	1756	1704	2013	0	639	663	1314	1341	1755	258	897	921	1572	1599	2013	1458	1791	1719	2052	0	639	663	1323	1329	1791	261	900	924	1584	1590	2052
62	BT_Cry1Db1	NOV_Cry1Da1_83.2_AIW52615.1	domain1	domain1	minor	130	729	271	870	0	603	627	1203	1233	1629	141	744	768	1344	1374	1770	130	729	271	870	0	603	627	1200	1233	1632	141	744	768	1341	1374	1773
62	BT_Cry1Db1	NOV_Cry1Da1_84.8_ABK35074.1	domain1	domain2	major	130	729	271	870	0	603	627	1203	1233	1629	141	744	768	1344	1374	1770	127	726	280	879	0	600	624	1200	1227	1638	153	753	777	1353	1380	1791
62	BT_Cry1Db1	BT_Cry1Da1	domain1	domain2	major	130	729	271	870	0	603	627	1203	1233	1629	141	744	768	1344	1374	1770	130	729	271	870	0	603	627	1203	1233	1629	141	744	768	1344	1374	1770
62	BT_Cry1Db1	BT_Cry1Da1	domain1	domain3	major	130	729	271	870	0	603	627	1203	1233	1629	141	744	768	1344	1374	1770	130	729	271	870	0	603	627	1203	1233	1629	141	744	768	1344	1374	1770
65	BT_Cry30Db1;BT_Cry30Da1	NOV_Cry30Ga2_64.5_ARJ25665.1	domain2	domain1	major	771	1339	1035	1603	0	633	657	1278	1308	1755	264	897	921	1542	1572	2019	768	1333	882	1447	0	630	654	1272	1302	1707	114	744	768	1386	1416	1821
65	BT_Cry30Db1;BT_Cry30Da1	NOV_Cry30Ga2_64.5_ARJ25665.1	domain2	domain3	major	771	1339	1035	1603	0	633	657	1278	1308	1755	264	897	921	1542	1572	2019	768	1333	882	1447	0	630	654	1272	1302	1707	114	744	768	1386	1416	1821
71	BT_Cry19Aa1	BT_Cry19Ca1	domain2	domain2	minor	617	1246	878	1507	0	609	633	1239	1269	1677	261	870	894	1500	1530	1938	599	1246	833	1480	0	591	630	1239	1263	1665	234	825	864	1473	1497	1899
71	BT_Cry19Aa1	BT_Cry1Ag1	domain2	domain3	major	617	1246	878	1507	0	609	633	1239	1269	1677	261	870	894	1500	1530	1938	611	1237	755	1381	0	603	627	1200	1230	1668	144	747	771	1344	1374	1812
71	BT_Cry19Aa1	BT_Cry1Id1	domain2	domain3	major	617	1246	878	1507	0	609	633	1239	1269	1677	261	870	894	1500	1530	1938	611	1264	839	1492	0	603	627	1257	1281	1695	228	831	855	1485	1509	1923
71	BT_Cry19Aa1	BT_Cry9Ga1	domain2	domain3	major	617	1246	878	1507	0	609	633	1239	1269	1677	261	870	894	1500	1530	1938	644	1312	863	1531	0	636	660	1302	1335	1743	219	855	879	1521	1554	1962
71	BT_Cry19Aa1	NOV_Cry1Ad2_87.7_AIW52617.1	domain2	domain3	major	617	1246	878	1507	0	609	633	1239	1269	1677	261	870	894	1500	1530	1938	611	1237	755	1381	0	603	627	1218	1224	1668	144	747	771	1362	1368	1812
71	BT_Cry19Aa1	BT_Cry1Ja1	domain2	domain3	major	617	1246	878	1507	0	609	633	1239	1269	1677	261	870	894	1500	1530	1938	611	1207	752	1348	0	603	627	1200	1230	1635	141	744	768	1341	1371	1776
71	BT_Cry19Aa1	BT_Cry1Ab12	domain2	domain3	major	617	1246	878	1507	0	609	633	1239	1269	1677	261	870	894	1500	1530	1938	611	1240	755	1384	0	603	627	1224	1230	1671	144	747	771	1368	1374	1815
71	BT_Cry19Aa1	NOV_Cry1Ab12_91.4_AAK14338.1	domain2	domain3	major	617	1246	878	1507	0	609	633	1239	1269	1677	261	870	894	1500	1530	1938	611	1240	749	1378	0	603	627	1224	1230	1671	138	741	765	1362	1368	1809
71	BT_Cry19Aa1	BT_Cry1Ia11	domain2	domain3	major	617	1246	878	1507	0	609	633	1239	1269	1677	261	870	894	1500	1530	1938	611	1264	839	1492	0	603	627	1257	1287	1698	228	831	855	1485	1515	1926
71	BT_Cry19Aa1	BT_Cry1Ma1	domain2	domain3	major	617	1246	878	1507	0	609	633	1239	1269	1677	261	870	894	1500	1530	1938	611	1252	839	1480	0	603	627	1245	1269	1683	228	831	855	1473	1497	1911
71	BT_Cry19Aa1	BT_Cry1Gb1	domain2	domain3	major	617	1246	878	1507	0	609	633	1239	1269	1677	261	870	894	1500	1530	1938	599	1210	737	1348	0	591	615	1203	1227	1641	138	729	753	1341	1365	1779
71	BT_Cry19Aa1	BT_Cry1Na1	domain2	domain1	major	617	1246	878	1507	0	609	633	1239	1269	1677	261	870	894	1500	1530	1938	608	1228	827	1447	0	600	624	1221	1251	1662	219	819	843	1440	1470	1881
71	BT_Cry19Aa1	BT_Cry1Na1	domain2	domain3	major	617	1246	878	1507	0	609	633	1239	1269	1677	261	870	894	1500	1530	1938	608	1228	827	1447	0	600	624	1221	1251	1662	219	819	843	1440	1470	1881
71	BT_Cry19Aa1	BT_Cry1A-like	domain2	domain3	major	617	1246	878	1507	0	609	633	1239	1269	1677	261	870	894	1500	1530	1938	597	1225	741	1369	0	366	714	1209	1215	1656	144	510	858	1353	1359	1800
71	BT_Cry19Aa1	BT_Cry1Fb1	domain2	domain3	major	617	1246	878	1507	0	609	633	1239	1269	1677	261	870	894	1500	1530	1938	611	1225	749	1363	0	603	627	1218	1248	1653	138	741	765	1356	1386	1791
71	BT_Cry19Aa1	BT_Cry1Ia18	domain2	domain3	major	617	1246	878	1507	0	609	633	1239	1269	1677	261	870	894	1500	1530	1938	611	1264	839	1492	0	603	627	1257	1287	1698	228	831	855	1485	1515	1926
71	BT_Cry19Aa1	BT_Cry1Aa10	domain2	domain3	major	617	1246	878	1507	0	609	633	1239	1269	1677	261	870	894	1500	1530	1938	611	1237	755	1381	0	603	627	1218	1224	1668	144	747	771	1362	1368	1812
71	BT_Cry19Aa1	BT_Cry1Ic1	domain2	domain3	major	617	1246	878	1507	0	609	633	1239	1269	1677	261	870	894	1500	1530	1938	605	1258	839	1492	0	597	621	1251	1281	1692	234	831	855	1485	1515	1926
71	BT_Cry19Aa1	NOV_Cry1Ab32_92.7_AAK14337.1	domain2	domain3	major	617	1246	878	1507	0	609	633	1239	1269	1677	261	870	894	1500	1530	1938	611	1240	755	1384	0	603	627	1224	1230	1671	144	747	771	1368	1374	1815
71	BT_Cry19Aa1	BT_Cry1Ab2	domain2	domain3	major	617	1246	878	1507	0	609	633	1239	1269	1677	261	870	894	1500	1530	1938	611	1249	755	1393	0	603	627	1239	1242	1674	144	747	771	1383	1386	1818
71	BT_Cry19Aa1	BT_Cry1Nb1	domain2	domain1	major	617	1246	878	1507	0	609	633	1239	1269	1677	261	870	894	1500	1530	1938	608	1228	737	1357	0	600	633	1221	1251	1650	129	729	762	1350	1380	1779
71	BT_Cry19Aa1	BT_Cry1Nb1	domain2	domain3	major	617	1246	878	1507	0	609	633	1239	1269	1677	261	870	894	1500	1530	1938	608	1228	737	1357	0	600	633	1221	1251	1650	129	729	762	1350	1380	1779
71	BT_Cry19Aa1	NOV_Cry1Da1_84.8_ABK35074.1	domain2	domain3	major	617	1246	878	1507	0	609	633	1239	1269	1677	261	870	894	1500	1530	1938	608	1207	761	1360	0	600	624	1200	1227	1638	153	753	777	1353	1380	1791
71	BT_Cry19Aa1	BT_Cry1Bb1	domain2	domain3	major	617	1246	878	1507	0	609	633	1239	1269	1677	261	870	894	1500	1530	1938	611	1270	749	1408	0	603	627	1263	1293	1698	138	741	765	1401	1431	1836
71	BT_Cry19Aa1	NOV_Cry1Ga1_77.9_AX098669.1	domain2	domain3	major	617	1246	878	1507	0	609	633	1239	1269	1677	261	870	894	1500	1530	1938	599	1216	737	1354	0	591	615	1209	1239	1650	138	729	753	1347	1377	1788
71	BT_Cry19Aa1	NOV_Cry1Ie5_79.3_PQQ47595.1	domain2	domain3	major	617	1246	878	1507	0	609	633	1239	1269	1677	261	870	894	1500	1530	1938	611	1264	839	1492	0	603	627	1257	1287	1695	228	831	855	1485	1515	1923
71	BT_Cry19Aa1	BT_Cry1Ad1	domain2	domain3	major	617	1246	878	1507	0	609	633	1239	1269	1677	261	870	894	1500	1530	1938	611	1237	755	1381	0	603	627	1224	1230	1668	144	747	771	1368	1374	1812
71	BT_Cry19Aa1	BT_Cry1Ie4	domain2	domain3	major	617	1246	878	1507	0	609	633	1239	1269	1677	261	870	894	1500	1530	1938	611	1270	839	1498	0	603	627	1263	1293	1704	228	831	855	1491	1521	1932
71	BT_Cry19Aa1	BT_Cry1Ga2	domain2	domain3	major	617	1246	878	1507	0	609	633	1239	1269	1677	261	870	894	1500	1530	1938	599	1201	740	1342	0	591	615	1194	1218	1635	141	732	756	1335	1359	1776
73	BT_Cry13Aa1	NOV_Cry13Aa1_50.1_ANS46780.1	domain3	domain3	minor	1398	1774	1695	2070	0	651	669	1329	1335	1773	297	948	966	1626	1632	2070	1443	1812	1734	2103	0	678	696	1371	1377	1812	291	969	987	1662	1668	2103
74	BT_Cry8Pa1	BT_Cry8Ja1	domain3	domain1	major	1343	1714	1601	1971	0	603	627	1290	1296	1713	258	861	885	1548	1554	1971	1322	1713	1586	1977	0	597	621	1233	1275	1713	264	861	885	1497	1539	1977
74	BT_Cry8Pa1	NOV_Cry8Ba1_88.6_AEP25412.1	domain3	domain2	major	1343	1714	1601	1971	0	603	627	1290	1296	1713	258	861	885	1548	1554	1971	1265	1614	1604	1953	0	606	630	1269	1299	1614	258	864	888	1527	1557	1872
74	BT_Cry8Pa1	BT_Cry8Ea2	domain3	domain1	major	1343	1714	1601	1971	0	603	627	1290	1296	1713	258	861	885	1548	1554	1971	1307	1683	1574	1950	0	597	621	1233	1257	1683	264	861	885	1497	1521	1947
75	NOV_Cry32Ta1_48.0_AQX37180.1	BT_Cry32Qa1	domain1	domain1	minor	1	536	334	869	0	675	699	1368	1398	1806	333	1008	1032	1701	1731	2139	1	536	310	845	0	663	687	1323	1353	1758	309	972	996	1632	1662	2067
75	NOV_Cry32Ta1_48.0_AQX37180.1	NOV_Cry32Va1_61.0_WP_134996253.1	domain1	domain2	major	1	536	334	869	0	675	699	1368	1398	1806	333	1008	1032	1701	1731	2139	4	497	265	758	0	639	663	1320	1350	1776	261	900	924	1581	1611	2037
75	NOV_Cry32Ta1_48.0_AQX37180.1	NOV_Cry32Va1_61.0_WP_134996253.1	domain1	domain3	major	1	536	334	869	0	675	699	1368	1398	1806	333	1008	1032	1701	1731	2139	4	497	265	758	0	639	663	1320	1350	1776	261	900	924	1581	1611	2037
75	NOV_Cry32Ta1_48.0_AQX37180.1	BT_Cry32Qa1	domain1	domain3	major	1	536	334	869	0	675	699	1368	1398	1806	333	1008	1032	1701	1731	2139	1	536	310	845	0	663	687	1323	1353	1758	309	972	996	1632	1662	2067
75	NOV_Cry32Ta1_48.0_AQX37180.1	BT_Cry32Ha1	domain1	domain3	major	1	536	334	869	0	675	699	1368	1398	1806	333	1008	1032	1701	1731	2139	1	512	259	770	0	639	663	1314	1341	1755	258	897	921	1572	1599	2013
75	NOV_Cry32Ta1_48.0_AQX37180.1	BT_Cry32Ta1	domain1	domain3	major	1	536	334	869	0	675	699	1368	1398	1806	333	1008	1032	1701	1731	2139	1	527	250	776	0	654	681	1287	1311	1728	249	903	930	1536	1560	1977
75	NOV_Cry32Ta1_48.0_AQX37180.1	BT_Cry32Hb1	domain1	domain3	major	1	536	334	869	0	675	699	1368	1398	1806	333	1008	1032	1701	1731	2139	1	512	259	770	0	639	663	1314	1341	1746	258	897	921	1572	1599	2004
75	NOV_Cry32Ta1_48.0_AQX37180.1	BT_Cry32Ka1	domain1	domain3	major	1	536	334	869	0	675	699	1368	1398	1806	333	1008	1032	1701	1731	2139	1	533	244	776	0	675	699	1356	1386	1812	243	918	942	1599	1629	2055
75	NOV_Cry32Ta1_48.0_AQX37180.1	BT_Cry32Va1	domain1	domain2	major	1	536	334	869	0	675	699	1368	1398	1806	333	1008	1032	1701	1731	2139	4	497	265	758	0	639	663	1320	1341	1758	261	900	924	1581	1602	2019
75	NOV_Cry32Ta1_48.0_AQX37180.1	BT_Cry32Va1	domain1	domain3	major	1	536	334	869	0	675	699	1368	1398	1806	333	1008	1032	1701	1731	2139	4	497	265	758	0	639	663	1320	1341	1758	261	900	924	1581	1602	2019
78	NOV_Cry56Aa2_56.0_AGV55019.1	NOV_Cry56Aa4_56.4_PEU80288.1	domain1	domain1	minor	1	679	280	958	0	612	651	1167	1188	1611	279	891	930	1446	1467	1890	1	682	280	961	0	612	654	1179	1200	1629	279	891	933	1458	1479	1908
78	NOV_Cry56Aa2_56.0_AGV55019.1	BT_Cry56Aa1	domain1	domain3	major	1	679	280	958	0	612	651	1167	1188	1611	279	891	930	1446	1467	1890	0	669	283	952	0	600	639	1158	1179	1611	285	885	924	1443	1464	1896
78	NOV_Cry56Aa2_56.0_AGV55019.1	NOV_Cry56Aa4_77.6_ARJ25668.1	domain1	domain3	major	1	679	280	958	0	612	651	1167	1188	1611	279	891	930	1446	1467	1890	0	669	277	946	0	597	636	1155	1176	1605	282	879	918	1437	1458	1887
78	NOV_Cry56Aa2_56.0_AGV55019.1	NOV_Cry56Aa4_56.4_PEU80288.1	domain1	domain2	major	1	679	280	958	0	612	651	1167	1188	1611	279	891	930	1446	1467	1890	1	682	280	961	0	612	654	1179	1200	1629	279	891	933	1458	1479	1908
78	NOV_Cry56Aa2_56.0_AGV55019.1	NOV_Cry56Aa4_79.3_WP_103592286.1	domain1	domain3	major	1	679	280	958	0	612	651	1167	1188	1611	279	891	930	1446	1467	1890	0	666	277	943	0	594	633	1152	1173	1605	282	876	915	1434	1455	1887
84	NOV_Cry8Aa1_47.1_EEM92570.1	BT_Cry8Ea2	domain1	domain1	minor	19	525	94	600	0	609	633	1290	1320	1773	75	684	708	1365	1395	1848	13	513	277	777	0	597	621	1233	1257	1683	264	861	885	1497	1521	1947
84	NOV_Cry8Aa1_47.1_EEM92570.1	NOV_Cry8Ha1_89.4_ABB29866.1	domain1	domain3	major	19	525	94	600	0	609	633	1290	1320	1773	75	684	708	1365	1395	1848	4	510	268	774	0	594	615	1251	1272	1689	264	858	879	1515	1536	1953
84	NOV_Cry8Aa1_47.1_EEM92570.1	NOV_Cry8Ha1_89.8_ATY50148.1	domain1	domain3	major	19	525	94	600	0	609	633	1290	1320	1773	75	684	708	1365	1395	1848	4	510	274	780	0	594	624	1254	1278	1689	270	864	894	1524	1548	1959
84	NOV_Cry8Aa1_47.1_EEM92570.1	BT_Cry3Bb1	domain1	domain3	major	19	525	94	600	0	609	633	1290	1320	1773	75	684	708	1365	1395	1848	19	528	265	774	0	612	636	1254	1284	1698	246	858	882	1500	1530	1944
84	NOV_Cry8Aa1_47.1_EEM92570.1	BT_Cry1Ka2	domain1	domain3	major	19	525	94	600	0	609	633	1290	1320	1773	75	684	708	1365	1395	1848	19	519	157	657	0	603	627	1245	1269	1683	138	741	765	1383	1407	1821
84	NOV_Cry8Aa1_47.1_EEM92570.1	BT_Cry8Da1	domain1	domain3	major	19	525	94	600	0	609	633	1290	1320	1773	75	684	708	1365	1395	1848	19	522	274	777	0	606	630	1314	1320	1734	255	861	885	1569	1575	1989
84	NOV_Cry8Aa1_47.1_EEM92570.1	NOV_Cry8Da1_43.7_ANC11094.1	domain1	domain2	major	19	525	94	600	0	609	633	1290	1320	1773	75	684	708	1365	1395	1848	16	525	244	753	0	609	633	1272	1293	1713	228	837	861	1500	1521	1941
84	NOV_Cry8Aa1_47.1_EEM92570.1	NOV_Cry8Da1_43.7_ANC11094.1	domain1	domain3	major	19	525	94	600	0	609	633	1290	1320	1773	75	684	708	1365	1395	1848	16	525	244	753	0	609	633	1272	1293	1713	228	837	861	1500	1521	1941
84	NOV_Cry8Aa1_47.1_EEM92570.1	BT_Cry3Ba1	domain1	domain3	major	19	525	94	600	0	609	633	1290	1320	1773	75	684	708	1365	1395	1848	19	528	289	798	0	612	636	1254	1284	1698	270	882	906	1524	1554	1968
84	NOV_Cry8Aa1_47.1_EEM92570.1	BT_Cry1Ig1	domain1	domain3	major	19	525	94	600	0	609	633	1290	1320	1773	75	684	708	1365	1395	1848	19	519	247	747	0	603	627	1257	1275	1695	228	831	855	1485	1503	1923
84	NOV_Cry8Aa1_47.1_EEM92570.1	BT_Cry8Ha1	domain1	domain3	major	19	525	94	600	0	609	633	1290	1320	1773	75	684	708	1365	1395	1848	4	510	274	780	0	594	624	1254	1275	1692	270	864	894	1524	1545	1962
84	NOV_Cry8Aa1_47.1_EEM92570.1	BT_Cry1Fa1	domain1	domain3	major	19	525	94	600	0	609	633	1290	1320	1773	75	684	708	1365	1395	1848	9	519	147	657	0	603	627	1218	1248	1659	138	741	765	1356	1386	1797
84	NOV_Cry8Aa1_47.1_EEM92570.1	BT_Cry8Hb1	domain1	domain3	major	19	525	94	600	0	609	633	1290	1320	1773	75	684	708	1365	1395	1848	4	510	274	780	0	594	624	1251	1272	1689	270	864	894	1521	1542	1959
87	BT_Cry1Be1;BT_Cry1Bj1	BT_Cry1Ba1	domain1	domain1	minor	1	460	139	598	0	603	627	1257	1281	1692	138	741	765	1395	1419	1830	1	460	139	598	0	603	627	1260	1290	1701	138	741	765	1398	1428	1839
87	BT_Cry1Be1;BT_Cry1Bj1	BT_Cry1Bf1	domain1	domain1	minor	1	460	139	598	0	603	627	1257	1281	1692	138	741	765	1395	1419	1830	1	460	139	598	0	603	627	1260	1284	1695	138	741	765	1398	1422	1833
87	BT_Cry1Be1;BT_Cry1Bj1	BT_Cry1Bd1	domain1	domain2	major	1	460	139	598	0	603	627	1257	1281	1692	138	741	765	1395	1419	1830	1	460	139	598	0	603	627	1263	1293	1707	138	741	765	1401	1431	1845
87	BT_Cry1Be1;BT_Cry1Bj1	BT_Cry1Ag1	domain1	domain3	major	1	460	139	598	0	603	627	1257	1281	1692	138	741	765	1395	1419	1830	1	460	145	604	0	603	627	1200	1230	1668	144	747	771	1344	1374	1812
87	BT_Cry1Be1;BT_Cry1Bj1	BT_Cry1Id1	domain1	domain3	major	1	460	139	598	0	603	627	1257	1281	1692	138	741	765	1395	1419	1830	1	460	229	688	0	603	627	1257	1281	1695	228	831	855	1485	1509	1923
87	BT_Cry1Be1;BT_Cry1Bj1	BT_Cry9Ga1	domain1	domain3	major	1	460	139	598	0	603	627	1257	1281	1692	138	741	765	1395	1419	1830	1	487	220	706	0	636	660	1302	1335	1743	219	855	879	1521	1554	1962
87	BT_Cry1Be1;BT_Cry1Bj1	NOV_Cry1Ad2_87.7_AIW52617.1	domain1	domain3	major	1	460	139	598	0	603	627	1257	1281	1692	138	741	765	1395	1419	1830	1	460	145	604	0	603	627	1218	1224	1668	144	747	771	1362	1368	1812
87	BT_Cry1Be1;BT_Cry1Bj1	BT_Cry1Ja1	domain1	domain3	major	1	460	139	598	0	603	627	1257	1281	1692	138	741	765	1395	1419	1830	1	460	142	601	0	603	627	1200	1230	1635	141	744	768	1341	1371	1776
87	BT_Cry1Be1;BT_Cry1Bj1	BT_Cry1Ab12	domain1	domain3	major	1	460	139	598	0	603	627	1257	1281	1692	138	741	765	1395	1419	1830	1	460	145	604	0	603	627	1224	1230	1671	144	747	771	1368	1374	1815
87	BT_Cry1Be1;BT_Cry1Bj1	NOV_Cry1Ab12_91.4_AAK14338.1	domain1	domain3	major	1	460	139	598	0	603	627	1257	1281	1692	138	741	765	1395	1419	1830	1	460	139	598	0	603	627	1224	1230	1671	138	741	765	1362	1368	1809
87	BT_Cry1Be1;BT_Cry1Bj1	BT_Cry1Ia11	domain1	domain3	major	1	460	139	598	0	603	627	1257	1281	1692	138	741	765	1395	1419	1830	1	460	229	688	0	603	627	1257	1287	1698	228	831	855	1485	1515	1926
87	BT_Cry1Be1;BT_Cry1Bj1	BT_Cry1Ma1	domain1	domain3	major	1	460	139	598	0	603	627	1257	1281	1692	138	741	765	1395	1419	1830	1	460	229	688	0	603	627	1245	1269	1683	228	831	855	1473	1497	1911
87	BT_Cry1Be1;BT_Cry1Bj1	BT_Cry1Gb1	domain1	domain3	major	1	460	139	598	0	603	627	1257	1281	1692	138	741	765	1395	1419	1830	1	460	139	598	0	591	615	1203	1227	1641	138	729	753	1341	1365	1779
87	BT_Cry1Be1;BT_Cry1Bj1	BT_Cry1Na1	domain1	domain3	major	1	460	139	598	0	603	627	1257	1281	1692	138	741	765	1395	1419	1830	0	462	208	670	0	600	624	1221	1251	1662	219	819	843	1440	1470	1881
87	BT_Cry1Be1;BT_Cry1Bj1	BT_Cry1A-like	domain1	domain3	major	1	460	139	598	0	603	627	1257	1281	1692	138	741	765	1395	1419	1830	1	449	145	593	0	366	714	1209	1215	1656	144	510	858	1353	1359	1800
87	BT_Cry1Be1;BT_Cry1Bj1	BT_Cry1Fb1	domain1	domain3	major	1	460	139	598	0	603	627	1257	1281	1692	138	741	765	1395	1419	1830	1	460	139	598	0	603	627	1218	1248	1653	138	741	765	1356	1386	1791
87	BT_Cry1Be1;BT_Cry1Bj1	BT_Cry1Ia18	domain1	domain3	major	1	460	139	598	0	603	627	1257	1281	1692	138	741	765	1395	1419	1830	1	460	229	688	0	603	627	1257	1287	1698	228	831	855	1485	1515	1926
87	BT_Cry1Be1;BT_Cry1Bj1	BT_Cry1Aa10	domain1	domain3	major	1	460	139	598	0	603	627	1257	1281	1692	138	741	765	1395	1419	1830	1	460	145	604	0	603	627	1218	1224	1668	144	747	771	1362	1368	1812
87	BT_Cry1Be1;BT_Cry1Bj1	BT_Cry1Ic1	domain1	domain3	major	1	460	139	598	0	603	627	1257	1281	1692	138	741	765	1395	1419	1830	0	459	229	688	0	597	621	1251	1281	1692	234	831	855	1485	1515	1926
87	BT_Cry1Be1;BT_Cry1Bj1	NOV_Cry1Ab32_92.7_AAK14337.1	domain1	domain3	major	1	460	139	598	0	603	627	1257	1281	1692	138	741	765	1395	1419	1830	1	460	145	604	0	603	627	1224	1230	1671	144	747	771	1368	1374	1815
87	BT_Cry1Be1;BT_Cry1Bj1	BT_Cry1Ab2	domain1	domain3	major	1	460	139	598	0	603	627	1257	1281	1692	138	741	765	1395	1419	1830	1	460	145	604	0	603	627	1239	1242	1674	144	747	771	1383	1386	1818
87	BT_Cry1Be1;BT_Cry1Bj1	BT_Cry1Nb1	domain1	domain3	major	1	460	139	598	0	603	627	1257	1281	1692	138	741	765	1395	1419	1830	0	459	121	580	0	600	633	1221	1251	1650	129	729	762	1350	1380	1779
87	BT_Cry1Be1;BT_Cry1Bj1	NOV_Cry1Da1_84.8_ABK35074.1	domain1	domain3	major	1	460	139	598	0	603	627	1257	1281	1692	138	741	765	1395	1419	1830	1	457	154	610	0	600	624	1200	1227	1638	153	753	777	1353	1380	1791
87	BT_Cry1Be1;BT_Cry1Bj1	BT_Cry1Bb1	domain1	domain2	major	1	460	139	598	0	603	627	1257	1281	1692	138	741	765	1395	1419	1830	1	460	139	598	0	603	627	1263	1293	1698	138	741	765	1401	1431	1836
87	BT_Cry1Be1;BT_Cry1Bj1	BT_Cry1Bb1	domain1	domain3	major	1	460	139	598	0	603	627	1257	1281	1692	138	741	765	1395	1419	1830	1	460	139	598	0	603	627	1263	1293	1698	138	741	765	1401	1431	1836
87	BT_Cry1Be1;BT_Cry1Bj1	NOV_Cry1Ga1_77.9_AX098669.1	domain1	domain3	major	1	460	139	598	0	603	627	1257	1281	1692	138	741	765	1395	1419	1830	1	460	139	598	0	591	615	1209	1239	1650	138	729	753	1347	1377	1788
87	BT_Cry1Be1;BT_Cry1Bj1	NOV_Cry1Ie5_79.3_PQQ47595.1	domain1	domain3	major	1	460	139	598	0	603	627	1257	1281	1692	138	741	765	1395	1419	1830	1	460	229	688	0	603	627	1257	1287	1695	228	831	855	1485	1515	1923
87	BT_Cry1Be1;BT_Cry1Bj1	BT_Cry1Ad1	domain1	domain3	major	1	460	139	598	0	603	627	1257	1281	1692	138	741	765	1395	1419	1830	1	460	145	604	0	603	627	1224	1230	1668	144	747	771	1368	1374	1812
87	BT_Cry1Be1;BT_Cry1Bj1	BT_Cry1Ie4	domain1	domain3	major	1	460	139	598	0	603	627	1257	1281	1692	138	741	765	1395	1419	1830	1	460	229	688	0	603	627	1263	1293	1704	228	831	855	1491	1521	1932
87	BT_Cry1Be1;BT_Cry1Bj1	BT_Cry1Ga2	domain1	domain3	major	1	460	139	598	0	603	627	1257	1281	1692	138	741	765	1395	1419	1830	0	459	139	598	0	591	615	1194	1218	1635	141	732	756	1335	1359	1776
95	NOV_Cry2Ab4_93.2_AIT70915.1	BT_Cry2Al1	domain1	domain1	minor	1	476	199	674	0	582	597	1212	1251	1674	198	780	795	1410	1449	1872	0	475	199	674	0	579	594	1209	1248	1671	201	780	795	1410	1449	1872
95	NOV_Cry2Ab4_93.2_AIT70915.1	BT_Cry2Ag1	domain1	domain2	major	1	476	199	674	0	582	597	1212	1251	1674	198	780	795	1410	1449	1872	0	478	199	677	0	582	597	1212	1281	1680	201	783	798	1413	1482	1881
95	NOV_Cry2Ab4_93.2_AIT70915.1	BT_Cry2Ag1	domain1	domain3	major	1	476	199	674	0	582	597	1212	1251	1674	198	780	795	1410	1449	1872	0	478	199	677	0	582	597	1212	1281	1680	201	783	798	1413	1482	1881
95	NOV_Cry2Ab4_93.2_AIT70915.1	BT_Cry2Ab12	domain1	domain2	major	1	476	199	674	0	582	597	1212	1251	1674	198	780	795	1410	1449	1872	0	475	199	674	0	579	594	1209	1248	1671	201	780	795	1410	1449	1872
95	NOV_Cry2Ab4_93.2_AIT70915.1	BT_Cry2Ab15	domain1	domain2	major	1	476	199	674	0	582	597	1212	1251	1674	198	780	795	1410	1449	1872	0	475	199	674	0	579	594	1209	1248	1674	201	780	795	1410	1449	1875
95	NOV_Cry2Ab4_93.2_AIT70915.1	BT_Cry2Ab15	domain1	domain3	major	1	476	199	674	0	582	597	1212	1251	1674	198	780	795	1410	1449	1872	0	475	199	674	0	579	594	1209	1248	1674	201	780	795	1410	1449	1875
96	NOV_Cry19Ba1_74.0_AGV55021.1	BT_Cry19Ba1	domain1	domain1	minor	1	673	244	916	0	591	630	1239	1257	1665	243	834	873	1482	1500	1908	4	676	244	916	0	594	633	1242	1266	1662	240	834	873	1482	1506	1902
96	NOV_Cry19Ba1_74.0_AGV55021.1	BT_Cry19Aa1	domain1	domain2	major	1	673	244	916	0	591	630	1239	1257	1665	243	834	873	1482	1500	1908	7	676	268	937	0	609	633	1239	1269	1677	261	870	894	1500	1530	1938
96	NOV_Cry19Ba1_74.0_AGV55021.1	BT_Cry19Ca1	domain1	domain2	major	1	673	244	916	0	591	630	1239	1257	1665	243	834	873	1482	1500	1908	1	673	235	907	0	591	630	1239	1263	1665	234	825	864	1473	1497	1899
96	NOV_Cry19Ba1_74.0_AGV55021.1	BT_Cry19Ca1	domain1	domain3	major	1	673	244	916	0	591	630	1239	1257	1665	243	834	873	1482	1500	1908	1	673	235	907	0	591	630	1239	1263	1665	234	825	864	1473	1497	1899
98	BT_Cry3Bb1;BT_Cry3Ba1	BT_Cry8Da1	domain3	domain3	minor	1326	1686	1572	1932	0	612	636	1254	1284	1698	246	858	882	1500	1530	1944	1368	1722	1623	1977	0	606	630	1314	1320	1734	255	861	885	1569	1575	1989
98	BT_Cry3Bb1;BT_Cry3Ba1	BT_Cry3Aa10	domain3	domain2	major	1326	1686	1572	1932	0	612	636	1254	1284	1698	246	858	882	1500	1530	1944	1311	1659	1587	1935	0	603	627	1239	1269	1674	276	879	903	1515	1545	1950
98	BT_Cry3Bb1;BT_Cry3Ba1	NOV_Cry3Aa12_81.9_AEZ53144.1	domain3	domain2	major	1326	1686	1572	1932	0	612	636	1254	1284	1698	246	858	882	1500	1530	1944	1311	1659	1563	1911	0	579	708	1239	1269	1674	252	831	960	1491	1521	1926
98	BT_Cry3Bb1;BT_Cry3Ba1	BT_Cry3Ca1	domain3	domain1	major	1326	1686	1572	1932	0	612	636	1254	1284	1698	246	858	882	1500	1530	1944	1323	1677	1572	1926	0	600	624	1251	1278	1689	249	849	873	1500	1527	1938
98	BT_Cry3Bb1;BT_Cry3Ba1	BT_Cry3Ca1	domain3	domain2	major	1326	1686	1572	1932	0	612	636	1254	1284	1698	246	858	882	1500	1530	1944	1323	1677	1572	1926	0	600	624	1251	1278	1689	249	849	873	1500	1527	1938
103	NOV_Cry40Da1_65.0_CAH33957.1	NOV_Cry40Da1_81.5_AIN76756.1	domain3	domain2	major	1280	1669	1499	1887	0	624	648	1236	1266	1668	219	843	867	1455	1485	1887	1289	1659	1511	1881	0	639	663	1248	1281	1659	222	861	885	1470	1503	1881
103	NOV_Cry40Da1_65.0_CAH33957.1	BT_Cry40Da1	domain3	domain2	major	1280	1669	1499	1887	0	624	648	1236	1266	1668	219	843	867	1455	1485	1887	1295	1668	1517	1890	0	642	666	1257	1284	1668	219	861	885	1476	1503	1887
103	NOV_Cry40Da1_65.0_CAH33957.1	NOV_Cry40Da1_66.9_PEU78339.1	domain3	domain1	major	1280	1669	1499	1887	0	624	648	1236	1266	1668	219	843	867	1455	1485	1887	1280	1656	1502	1878	0	624	648	1242	1266	1656	219	843	867	1461	1485	1875
103	NOV_Cry40Da1_65.0_CAH33957.1	NOV_Cry40Da1_77.3_ARJ25823.1	domain3	domain2	major	1280	1669	1499	1887	0	624	648	1236	1266	1668	219	843	867	1455	1485	1887	1289	1659	1514	1884	0	639	663	1251	1278	1659	222	861	885	1473	1500	1881
104	NOV_Cry21Aa2_44.6_AZR80772.1	BT_Cry21Aa1	domain3	domain3	minor	1361	1672	1625	1935	0	627	639	1227	1233	1671	264	891	903	1491	1497	1935	1478	1773	1763	2058	0	696	723	1365	1371	1773	279	975	1002	1644	1650	2052
104	NOV_Cry21Aa2_44.6_AZR80772.1	BT_Cry21Ba1	domain3	domain3	minor	1361	1672	1625	1935	0	627	639	1227	1233	1671	264	891	903	1491	1497	1935	1433	1761	2072	2400	0	687	711	1347	1353	1761	279	966	990	1626	1632	2040
107	BT_Cry52Ca1	NOV_Cry52Ca1_62.9_AZJ24464.1	domain2	domain2	minor	447	1214	690	1457	0	591	630	1236	1266	1662	243	834	873	1479	1509	1905	438	1205	687	1454	0	582	621	1227	1251	1671	249	831	870	1476	1500	1920
107	BT_Cry52Ca1	NOV_Cry52Ca1_62.9_AZJ24464.1	domain2	domain1	major	447	1214	690	1457	0	591	630	1236	1266	1662	243	834	873	1479	1509	1905	438	1205	687	1454	0	582	621	1227	1251	1671	249	831	870	1476	1500	1920
107	BT_Cry52Ca1	BT_Cry52Ba1	domain2	domain1	major	447	1214	690	1457	0	591	630	1236	1266	1662	243	834	873	1479	1509	1905	465	1265	714	1514	0	609	651	1287	1311	1701	249	858	900	1536	1560	1950
107	BT_Cry52Ca1	BT_Cry40Aa1	domain2	domain3	major	447	1214	690	1457	0	591	630	1236	1266	1662	243	834	873	1479	1509	1905	519	1268	669	1418	0	678	702	1284	1320	1707	150	828	852	1434	1470	1857
107	BT_Cry52Ca1	BT_Cry52Aa1	domain2	domain1	major	447	1214	690	1457	0	591	630	1236	1266	1662	243	834	873	1479	1509	1905	471	1274	726	1529	0	615	657	1296	1320	1704	255	870	912	1551	1575	1959
109	NOV_Cry69Ab1_58.0_PEU83535.1	BT_Cry69Aa1	domain3	domain3	minor	1231	1690	1474	1932	0	588	612	1236	1269	1689	243	831	855	1479	1512	1932	1255	1716	1537	1998	0	600	630	1263	1296	1716	279	879	909	1542	1575	1995
109	NOV_Cry69Ab1_58.0_PEU83535.1	BT_Cry69Ab1	domain3	domain3	minor	1231	1690	1474	1932	0	588	612	1236	1269	1689	243	831	855	1479	1512	1932	1255	1719	1534	1998	0	600	630	1260	1293	1719	279	879	909	1539	1572	1998
109	NOV_Cry69Ab1_58.0_PEU83535.1	NOV_Cry69Ab1_59.2_WP_103591619.1	domain3	domain1	major	1231	1690	1474	1932	0	588	612	1236	1269	1689	243	831	855	1479	1512	1932	1243	1692	1486	1935	0	588	612	1245	1281	1692	243	831	855	1488	1524	1935
109	NOV_Cry69Ab1_58.0_PEU83535.1	NOV_Cry69Aa2_62.7_WP_103591151.1	domain3	domain1	major	1231	1690	1474	1932	0	588	612	1236	1269	1689	243	831	855	1479	1512	1932	1240	1701	1477	1938	0	594	618	1248	1278	1701	237	831	855	1485	1515	1938
109	NOV_Cry69Ab1_58.0_PEU83535.1	NOV_Cry69Aa2_62.7_WP_103591151.1	domain3	domain2	major	1231	1690	1474	1932	0	588	612	1236	1269	1689	243	831	855	1479	1512	1932	1240	1701	1477	1938	0	594	618	1248	1278	1701	237	831	855	1485	1515	1938
112	NOV_Cry7Ea2_99.9_AFI42038.1	NOV_Cry8Ca1_42.6_ABY46520.1	domain3	domain3	minor	1285	1660	1525	1900	0	609	633	1272	1293	1719	240	849	873	1512	1533	1959	1267	1636	1522	1891	0	606	633	1251	1275	1674	255	861	888	1506	1530	1929
112	NOV_Cry7Ea2_99.9_AFI42038.1	NOV_Cry8Ca1_41.2_AST51780.1	domain3	domain3	minor	1285	1660	1525	1900	0	609	633	1272	1293	1719	240	849	873	1512	1533	1959	1282	1623	1543	1884	0	612	636	1266	1290	1683	261	873	897	1527	1551	1944
112	NOV_Cry7Ea2_99.9_AFI42038.1	NOV_Cry7Ca1_86.8_AGM39664.1	domain3	domain2	major	1285	1660	1525	1900	0	609	633	1272	1293	1719	240	849	873	1512	1533	1959	1285	1672	1504	1891	0	609	633	1269	1299	1731	219	828	852	1488	1518	1950
112	NOV_Cry7Ea2_99.9_AFI42038.1	NOV_Cry7Ca1_99.7_ABR67863.2	domain3	domain1	major	1285	1660	1525	1900	0	609	633	1272	1293	1719	240	849	873	1512	1533	1959	1285	1648	1504	1867	0	609	633	1269	1296	1698	219	828	852	1488	1515	1917
112	NOV_Cry7Ea2_99.9_AFI42038.1	NOV_Cry7Ca1_99.7_ABR67863.2	domain3	domain2	major	1285	1660	1525	1900	0	609	633	1272	1293	1719	240	849	873	1512	1533	1959	1285	1648	1504	1867	0	609	633	1269	1296	1698	219	828	852	1488	1515	1917
113	BT_Cry65Aa2	NOV_Cry65Aa2_55.6_PDY37670.1	domain3	domain3	minor	1506	1905	1785	2184	0	813	843	1467	1500	1908	279	1092	1122	1746	1779	2187	1581	1980	1770	2169	0	834	867	1551	1572	1986	189	1023	1056	1740	1761	2175
119	BT_Cry14Ab1	NOV_Cry14Ab1_85.6_AXE15628.1	domain1	domain1	minor	1	764	253	1016	0	672	702	1311	1353	1779	252	924	954	1563	1605	2031	1	764	253	1016	0	672	690	1338	1344	1770	252	924	942	1590	1596	2022
119	BT_Cry14Ab1	BT_Cry14Aa1	domain1	domain2	major	1	764	253	1016	0	672	702	1311	1353	1779	252	924	954	1563	1605	2031	1	764	253	1016	0	672	702	1302	1344	1776	252	924	954	1554	1596	2028
119	BT_Cry14Ab1	BT_Cry14Aa1	domain1	domain3	major	1	764	253	1016	0	672	702	1311	1353	1779	252	924	954	1563	1605	2031	1	764	253	1016	0	672	702	1302	1344	1776	252	924	954	1554	1596	2028
